WWWGGGGGGG
WSWGGGGGGG
WGWWWWWWWW
WAGGGGGGEW
WWWWWWWWWW
