WWWGGGGGGG
WSWGGGGGGG
WGWWWWWWWW
WGGGGGGGEW
WWWWWWWWWW
