TTTTTTTTTTTTTTT
L             R
L             R
L       4     R
L             R
L             R
L             R
L             R
L             R
BBBBBBBBBBBBBBB
