    WWW
    WSW
WWWWWGWWWW
WGGGGGGGGW
WGWWWWWWGW
WGGGEWWGGW
WWWWWWWWWW
