WWWWWWWWW
WSWGGGGGW
WGWGWGWGW
WGWWWGWGW
WGGGGGWGW
WWWWWWWGW
WEGGGGGGW
WWWWWWWWW
