WWWWWWWWWWWWWWWWWWWWWWWWWWWWWWWWWW
W                                W
W                                W
W   "HE IS BEGINNING TO BELIEVE" W
W                                W
W                                W
WWWWWWWWWWWWWWWWWWWWWWWWWWWWWWWWWW
