WWWWWWWWWWWWWWWWWWWWWWWWWWWWWWW
WSGWGGGGGGGGWGGGGGGGGWGGGGGGGGW
WGGWWWWGGWGGWGGWWWWGGWWWWWWWGGW
WGGGGGGGGWGGWGGWGGGGGGGGGGGGGGW
WWWWWWWWWWGGWGGWGGWGGWWWWWWWGGW
WGGGGGGGGGGGGGGWGGWGGWGGGGGWGGW
WGGWWWWWWWWWWWWWWWWGGWWWWGGWGGW
WGGGGGWGGGGGWGGGGGGGGWGGGGGWGGW
WGGWGGWWWWGGWGGWWWWWWWGGWWWWWWW
WGGWGGGGGGGGWGGGGGGGGWGGGGGGGGW
WWWWWWWWWWWWWWWWWWWGGWWWWWWWGGW
WGGGGGGGGGGGGGGGGGGGGWGGGGGWGGW
WGGWWWWWWWWWWWWWWWWWWWGGWGGWGGW
WGGWGGWGGGGGWGGGGGGGGGGGWGGWGGW
WGGWGGWGGWGGWGGWWWWGGWWWWWWWGGW
WGGWGGGGGWGGWGGGGGWGGGGGWGGGGGW
WGGWGGWWWWGGWWWWGGWWWWGGWGGWWWW
WGGWGGGGGWGGGGGGGGWGGWGGWGGWGGW
WGGWWWWWWWGGWGGWGGWGGWGGWGGWGGW
WGGGGGGGGGGGWGGWGGGGGWGGGGGGGEW
WWWWWWWWWWWWWWWWWWWWWWWWWWWWWWW
